Kingdom - управленец (здания, ресурсы, войска и тп);
KingdomLeader - лицо принимающее решения;

Resource - единица использования/производства;
ResourceHolder - хранитель ресурсов, содержит различные ресурсы для управления ими;
ResourceProducer - производитель ресурсов, производит ресурсы определенного типа/типов;
ResourcePicker - собиратель ресурсов;

Army - единица управления войсками, позволяет планировать стратегические действия;
Troop - отряд(войско) используется атак и защиты;

Alliance - умный договор между несколькими королевствами;
AllianceLeader - руководитель альянса, лицо принимающее решение;
AllianceCreator - создатель альянса, позволяет создать альянс между несколькими королевствами на основе определенных документов и договоренностей;
(c альянсом пока туманно, возможно не стоит включать в реализацию совсем)

KingdomLeaderboard - хранилище рейтинга королевств;
KingdomRating - рейтинг конкретного королевства;
KingdomRatingRule - правило расчета рейтинга на основе конкретного события произошедшего с королевством;
KingdomRatingManager - менеджер рейтинга королевства на основе заданных правил;

BuildingConstructor - создатель/улучшатель зданий, позволяет создать здание определенного типа используя ресурсы; 
Building - строение имеющее набор характеристик и выполняющих одну функцию (ResourceBuilding - здание, генерирующее ресурсы определенного типов/типа и другие);

P.S
выделенные наблюдения.

Королевство - по сути является единицой УПРАВЛЕНИЯ. Содержит внутри себя здания и набор ресурсов и войска. 

Ресурс - единица использования/производства.
По сути ресурсом может обладать и генерировать практически любой элемент системы,
Количество ресурса и его использование уже относится к конкретной сущности.
(по сути армия может обладать ресурсом золота, и тп после успешного нападения на другое королевство
а потом передавать его уже в альянс или свое королевство)

Армия - обособленная единица, которой можно управлять, может состоять из различных отрядов(войск) - по сути управляемый пул.
Войско - может атаковать и защищать конкретные объекты имеет тип (лучники ближний бой и тп)
(таким образом выделяя войско, можем его переиспользовать как обособленную единицу - создать войско кочевников и нанимать их к себе в армию допустим за деньги)

Альянс - договор между несколькими королевствами. (пока не смог нормально продумать, не понимаю концепции до конца)

Доска лидеров - хранилище рейтинга королевств. Другие сущности не должны ничего знать о доске лидеров.
Рейтинг каждого королевства начинается с дефолтного значения и увеличивается/уменьшается со временем.
В зависимости от происходящих событий с королевством.
 
Здание - строение имеющее набор характеристик и выполняющее одну функцию. 
Создается/Модернизируется с помощью строителей - королевство имеет некий пул строителей по-умолчанию, умеющий делать определенный тип зданий.
(В теории можно сделать так что строители ушли/убили из королевства и ничего построить нельзя.
В таком случае нужно выкупать строителей у других королевств.)
