Кластер королевства
Kingdom - по сути просто большой набор для управления (армия, ресурсы, здания),
KingdomLeader - основной АТД для управления королевством, ЛПР (может принимать различные стратегия управления разными ресурсами И Т П)

Кластер ресурсов
Resource - (не особо думаю что это АТД, поскольку просто класс характеризиуются количество ресурса именем и другими атрибутами)
ресурсы будут использоваться практически везде

Gold - золото
Food - еда
Qaurry - камни

ResourceManager - менеджер ресурсов, занимается сбором переводом и получением/приобритением ресурсов, может принимать различные стратегии.


Кластер армии
Army - группа войск АТД, которые могут контролироваться и управляться с помощью различных стратегий.

Troop - войско АТД, используются для нападения/защиты, могут управляться с помощью различных стратегий:
Archers - лучники, атакуют в дальнем бою, поддерживают войска ближнего боя, занимаются разведкой.
Infantry - пехота, занимаются обороной, осадами, атаками ближнего боя.
Cavalry - кавалерия, преследование, быстрые атаки.

Кластер рейтинга
здесь совсем нет АТД, это чисто доп функционал, который будет собирать события из королевства и считать рейтинг.

KingdomLeaderboard - хранилище рейтинга королевств;
KingdomRating - рейтинг конкретного королевства;

KingdomRatingRule - правило расчета рейтинга на основе конкретного события произошедшего с королевством;
EconomicStatusRule - учитывает такие факторы, как количество золота и ресурсов, которыми обладает королевство, а также его способность торговать с другими королевствами;
MilitaryStatusRule - учитывает такие факторы, как количество и качество войск, а также способность королевства защищаться от нападений;
TechnologicalAdvancementRule - учитывает такие факторы, как количество передовых зданий и ресурсов, которыми обладает королевство, а также способность королевства к исследованиям и разработке новых технологий;

KingdomRatingManager - единственная обязанность управление рейтингами королевств на основе установленных правил;

Кластер строений

BuildingConstructor - АТД конструктор зданий, может создавать новые здания или модернизировать существующие, основываясь на доступных ресурсах и наличии строителей (по сути управленец некий).
Builder - строитель, единичный элемент, который умеет строить один или несколько конкретных типов зданий (имеет скилл, имя и тп)
Building - АТД, (может принимать различные стратегии управления)
типы строений

ResourceBuilding - здание для добычи ресурсов:
LumberMillBuilding - лесопилка
GoldMineBuilding - золотодобывающая шахта
FarmBuilding - ферма, генерирует еду
QuarryBuilding - каменоломня, для генерации камней

DefensiveBuilding - "защитные" здания
WallBuilding - барьер для защиты от атак
GateBulding - основные ворота 

MilitaryBuilding - "армейские" здания
BarrackBuilding  - барак для тренировки войск ближнего боя 
StableBulding - здание для тренировки кавалерии

KingdomBuilding - здания принадлежащее королевству, улучшающие его экономику.

BankBulding - здание банка, увеличивает приток золота в королевство 
MarketBuilding - здание рынка, используется для торговли с другими королевствами


P.S Альянс выкинул из кластеров, пока не вижу как его правильно описать и реализовать.